#!/bin/sh

echo "
Thank You For Installing StagePad v1.0.0

Created by sourcelocation & Erast

⠀⠀⠀⠀⠀⠀⠀⠀⠀⠀⠀⠀⠀⠀⠀⠉⢡⣁⣤⣽⣽⣭⣍⠀⠀⠀⠀⠀⠀⠀
⠀⠀⠀⠀⠀⠀⠀⠀⠀⠀⠀⠀⠀⠀⢲⣿⣿⣿⣿⣿⣿⢿⡿⣿⣦⣄⠀⠀⠀⠀
⠀⠀⠀⠀⠀⠀⠀⠀⠀⠀⠀⠀⠀⢠⣿⣿⣿⣿⣿⣿⣿⣾⣿⣿⣽⢿⡆⠀⠀⠀
⠀⠀⠀⠀⠀⠀⠀⠀⠀⠀⠀⠀⠀⢸⣿⣿⣿⣿⡿⢋⣝⠛⠿⠿⣿⣿⠛⠀⠀⠀
⠀⠀⠀⠀⠀⠀⠀⠀⠀⠀⠀⠀⠀⢸⣿⣿⡿⠛⣥⣿⣥⢰⠃⠀⠈⡿⠀⠀⠀⠀
⠀⠀⠀⠀⠀⠀⠀⠀⠀⠀⠀⠀⢀⣿⣟⣿⠣⣤⣿⣿⣿⣿⣷⣷⣤⡇⠀⠀⠀⠀
⠀⠀⠀⠀⠀⠀⠀⠀⠀⠀⠀⠀⠀⢻⣿⣿⣆⠙⣿⣮⣉⣿⣿⠛⠛⠁⠀⠀⠀⠀
⠀⠀⠀⠀⠀⠀⠀⠀⠀⠀⠀⠀⠀⡞⣿⢻⣿⣿⣿⣿⣿⣿⣿⡂⠎⠀⠀⠀⠀⠀
⠀⠀⠀⠀⠀⠀⠀⠀⠀⠀⠀⠀⢰⠣⡿⢿⣿⣿⣿⣿⣿⣯⣓⡟⠀⠀⠀⠀⠀⠀
⢤⣶⣶⣦⣤⣶⣶⠿⠻⢭⣻⡟⠁⢸⡿⠁⣝⢿⣿⣿⣿⣿⣿⠁⠀⠀⠀⠀⠀⠀
⠟⣹⣴⣿⣿⣿⣿⡿⣾⣿⡏⠠⢰⢸⣧⢀⣼⡿⠟⠛⠛⡛⠫⢀⠀⠀⠀⠀⠀⠀
⡏⢛⣽⣿⣿⣿⣿⣇⣻⣿⣧⣀⢸⠘⣧⡟⣧⣠⠄⠀⢠⣿⣶⣄⠑⢄⠀⠀⠀⠀
⢀⣾⡿⣿⣿⣿⣿⣿⣿⣿⣿⣿⣧⢸⣿⣗⣿⣟⡴⠂⣿⡿⠟⠳⠷⢄⠁⡀⠀⠀
⡏⢙⡟⣿⣿⣿⣿⣿⣿⣿⣿⣿⠻⣿⣿⣟⡁⣑⣤⠀⠀⢰⠀⠠⠀⠀⠁⠈⠂⢄
⣿⣘⣫⣿⣿⣿⣿⣿⣿⣿⣿⣿⣦⣿⣧⣬⣿⣿⣯⣧⣤⣟⣥⣔⣀⣀⣀⣀⣀⣀
"
